# U_MAZE
11111
10001
11101
10001
11111