11111111111111111111111111111111111111111111111111111111111111111111111111111111
10000100000000000000000000000000000000000000000000000000000000000001000000000001
10000010000000000000000000000000000000000000000000000000000000000010000000000001
10000001000000000000000000000000000000000000000000000000000000000100000000000001
10000000100000000000000000000000000000000000000000000000000000001000000000000001
10000000010000000000000000000000000000000000000000000000000000010000000000000001
10000000001000000000000000000000000000000000000000000000000000100000000000000001
10000000000100000000000000000000000000000000000000000000000001000000000000000001
10000000000010000000000000000000000000000000000000000000000010000000000000000001
10000000000001000000000000000000000000000000000000000000000100000000000000000001
10000000000000000000000000000000000000000000000000000000001000000000000000000001
10000000000000000000000000000000000000000000000000000000010000000000000000000001
10000000000000000000000000000000000000000000000000000000100000000000000000000001
10000000000000000000000000000000000000000000000000000001000000000000000000000001
10000000000000000000000000000000000000000000000000000010000000000000000000000001
10000000000000000001000000000000000000000000000000000100000000000000000000000001
10000000000000000000100000000000000000000000000000001000000000000000000000000001
10000000000000000000010000000000000000000000000000010000000000000000000000000001
10000000000000000000001000000000000000000000000000100000000000000000000000000001
10000000000000000000000100000000000000000000000001000000000000000000000000000001
10000000000000000000000010000000000000000000000010000001000000000000000000000001
10000000000000000000000001000000000000000000000100000001000000000000000000000001
10000000000000000000000000111111111100011111111000000001000000000000000000000001
10000000000000000000000000100000000000000000001000000001000000000000000000000001
10000000000000000000000000100000000000000000001000000001000000000000000000000001
10000000000000000000000000100000000000000000001000000001000000000000000000000001
10000000000000000000000000100000000000000000001000000001000000000000000000000001
10000000000000000000000000100000000000000000001000000001000000000000000000000001
10000000000000000000000000100000000000000000001000000001000000000000000000000001
10000000000000000000000000100000000000000000001000000001000000000000000000000001
10000000000000000000000000111111000000000000001111111111111100001111111111111111
10000000000000000000000000000000000000000000001000100000001000000000000000000001
10000000000000000000000000000000000000000000001000100000001000000000000000000001
10000000000000000000000000000000000000000000001000100000001000000000000000000001
10000000000000000000000000000000000000000000001000100000001000000000100000000001
10000000000000000000000000000000000000300000001000100000001000000000100000000001
11111111111111111111111111111111000000000000001000100000001000000000100000000001
10000000000000000000000000100000000000000000001000100000001000000000100000000001
10000000000000000000000000100000000000000000001000100001111111111100100111111111
10000000000000000000000000100000000000000000001000100000000000000000100000000001
10000000000000000000000000100000000000000000001000100000000000000000100000000001
10000000000000000000000000100000000000000000001000100000000000000000100000000001
10000000000000000000000000100000000000000000001000100000000000000000100000000001
10000000000000000000000000100000000000000000001000100000000000000000100000000001
11111111111111111111111111111111111100000111111111111111111000000111111111111111
10000000000000000000000000000001000000000000000000000000000000000000000000000001
10000000000000000000000000000001000000000000000000000000000000000000000000000001
10000000000000000000000000000001000000000000000000000000000000000000000000000001
10000000000000000000000000000001000000000000000000000000000000000000000000000001
10000000000000000000000000000001000000000000000000000000000010000000000000000001
10000000000000000000000000000001000000000000000000000000000010000000000000000001
10000000000000000000000000000001000000000000000000000000000010000000000000000001
10000000000000000000000000000001000000100000000000000000000011111111110000000001
10000000000000000000000000000001000000100000000000000000000010000000000000000001
10000000000000000000000000000001000000100000000000000000000010000000000000000001
10000000000000000000000000000001000000100000000000000000000010000000000000000001
10000000000000000000000000000001000000100000000000000000000010000000000000000001
10000000000000000000000000011111000000100000000000000000000010000000000000000001
10000000000000000000000000000000000000100000000000000000000010000000000000000001
10000000000000000000000000000000000000100000000000000000000000000000000000000001
10000000000000000000000000000000000000100000000001000000000000000000000000000001
10000000000000000000000000000000000000100000000001000000000000000000000000000001
10000000000000000000000000000000000000000000000001000000000000000000000000000001
10000000000000000000000000000000000000000000000001000000000000000000000000000001
10000000000000000000000000011111000000000011111111111111111100000000000000000001
10000000000000000000000000000001000000000000000001000000000000000000001000000001
10000000000000000000000000000001000000000000000001000000000000000000001000000001
10000000000000000000000000000001000000000000000001000000000000000000001000000001
10000000000000000000000000000001000000000000000001000000000000000000001000000001
10000000000000000000000000000001000000000000000001000000000000000000001000000001
10000000000000000000000000000001000000000000000000000000000000000000001000000001
10000000000000000000000000000001000000000000000000000000000011111111111000000001
10000000000000000000000000000001000000000000000000000000000000000000001000000001
10000000000000000000000000000001000000000000000000000000000000000000001000000001
10000000000000000000000000000001000000000000000000000000000000000000001000000001
10000000000000000000000000000001000000000000000000000000000000000000000000000001
10000000000000000000000000000001000000000000000000000000000000000000000000000001
10000000000000000000000000000001000000040000000000000000000000000000000000000001
10000000000000000000000000000001000000000000000000000000000000000000000000000001
11111111111111111111111111111111111111111111111111111111111111111111111111111111