# tiny wall U shaped maze
000000000000000000000000000000
000000000000000000000000000000
000400000000000000000000000000
000000000000000000000000000000
000000000000000000000000000000
000000000000000000000000000000
000000000000000000000000000000
000000000000000000000000000000
000000000000000000000000000000
000000000000000000000000000000
111111111111111111110000000000
111111111111111111110000000000
111111111111111111110000000000
111111111111111111110000000000
111111111111111111110000000000
111111111111111111110000000000
111111111111111111110000000000
111111111111111111110000000000
111111111111111111110000000000
111111111111111111110000000000
000000000000000000000000000000
000000000000000000000000000000
000000000000000000000000000000
000000000000000000000000000000
000000300000000000000000000000
000000000000000000000000000000
000000000000000000000000000000
000000000000000000000000000000
000000000000000000000000000000
000000000000000000000000000000